NO ./assets/wall_fantasy.png
SO ./assets/wall_fantasy2.png
WE ./assets/wall_fantasy3.png
EA ./assets/wall_fantasy4.png
F 41,42,37
C 86,79,87
111111111111111111111111111111111111111111111111111
100000000000100000011100000000000011111000000000011
11D111001100100000011100000000000011011001011111011
1000110011001001100001011001100000D0011001000001111
1000010011111001100001D1100110000011011001111001111
11000D000000000111111101111110000011110001100000001
1100010000000001011100000001111D111010001111D1D1D11
1110111111011111D1110001110111000110100011110101011
111011111101100000011011100111000D00110111111111011
111D111111D1100000011011111111000110110110000000011
100000111101100110011D111000111D1100110110000000011
10000W11100000011000000D000001101111110110000000011
100000111000000110000001110001100000000110000000011
111111111111111111111111111111111111111111111111111
