NO ./assets/wall_fantasy.png
SO ./assets/wall_fantasy2.png
WE ./assets/wall_fantasy3.png
EA ./assets/wall_fantasy4.png
F 41,42,37
C 86,79,87
         1111111111111111111111111
         1000000000110000000000001
    1    1101100000111000010000001
         10010000000000000D0000001
111111111011000001110000001000001
10000000001100000111011D11111111
1111011111111101110000001001
1111D11111111101110101001001
110000011010101110000001001
1000000000000000D000100E01
100000000000000111011010001
1101D1011101010111110111100111
11110111 1110101 101111010001
11111111 1111111 111111111111
