NO ./assets/wall_fantasy.xpm
SO ./assets/wall_fantasy2.xpm
WE ./assets/wall_fantasy3.xpm
EA ./assets/wall_fantasy4.xpm
F 39,37,35
C 39,37,35
         1111111111111111111111111
         1000000000110000000000001
    1    1101100000111000010000001
         10010000000000000D0000001
111111111011000001110000001000001
10000000001100000111011111111111
1111011111111101110000001001
1111D111111111011101010010001
1100000110101011100000010001
100000E00000000D00000010001
1000000000000001110101010001
1100000111010101111101111000111
11110111 1110101 101111010001
11111111 1111111 111111111111
