NO ./assets/wall64.png
SO ./assets/wall64.png
WE ./assets/wall64.png
EA ./assets/wall64.png
F 255,37,35
C 39,37,35
         1111111111111111111111111
         100000000011000000000000111
    1    1101100000111000010000001
         10010000000000000D0000001
111111111011000001110000001000001
10000000001100000111011111111111
1111011111111101110000001001
1111D11111111101110101001001
110000011010101110000001001
10000E0100000000D000100001
100000010000000111011010001
1101D1011101010111110111100111
11110111 1110101 101111010001
11111111 1111111 111111111111
