NO ./assets/wall_fantasy.xpm
SO ./assets/wall_fantasy2.xpm
WE ./assets/wall_fantasy3.xpm
EA ./assets/wall_fantasy4.xpm
F 65,103,64
C 39,37,35
         1111111111111111111111111
         100000000011000000000000111
    1    1101100000111000010000001
         10010000000000000D0000001
111111111011000001110000001000001
10000000001100000111011111111111
1111011111111101110000001001
1111D11111111101110101001001
110000011010101110000001001
10000E000001D10D0001000011
10000001000000111011010001
1101D1011101010111110111101111
11110111 1110101 101111010001
11111111 1111111 111111111111
