NO ./assets/blue.xpm
SO ./assets/red.xpm
WE ./assets/yellow.xpm
EA ./assets/green.xpm
F 65,103,64
C 2,11,83
111111
101011
1100W1
100001
111111
